XCCCGCCCCCCCCBCCCX
XCCCCCCCCCCCCCCCCX
XCCCCXCCCCCCXCCCCX
XXCCCCCCCCCCCCCCCX
XCCCCCCCCCCCCCCCXX
XCCXCCCCCCCXCCCCCX
XCCCCCCCCCCCCCCXCX
XXCCCCCCCCCCCCCCCX
XCCCCCCCCCCCCCCXCX
XCCCCXCCCCCCCCCCCX