XXXXXXXXXXXXXXXXXX
XXXXXXXXCCXXXXXXXX
XXXXXXXC  CXXXXXXX
XXXXXXC    CXXXXXX
XXXXXCCCCCCCCXXXXX
XXXXCC  BG  CCXXXX
XXXC  C XX C  CXXX
XXC    C  C    CXX
XC      CC      CX
XXXXXXXXXXXXXXXXXX