XXXXXCCC  CCCXXXXX
XXXX    CC    XXXX
XXXC   CXXC   CXXX
XXC   CXXXXC   CXX
XC   CXXXXXXC   CX
XC    CXXXXC    CX
XXC    CXXC    CXX
XXXC    CC    CXXX
XXXXGCCCCCCCCBXXXX
XXXXXXXXXXXXXXXXXX  