X                X
X                X
XG              BX
XXX            XXX
XCCCCCCCCCCCCCCCCX
XCCCCCCCCCCCCCCCCX
XCCCCCCCCCCCCCCCCX
XCCCCCCCCCCCCCCCCX
XCCCCCCCLCCCCCCCCX
XXXXXXXXXXXXXXXXXX             