XC              CX
XX    CCCCCC    XX
XC    XCCCCX    CX
XC    XCCCCX    CX
XC    XCCCCX    CX
XCC    XCCX    LCX
XXX    XCCX    XXX
XC     XCCX     CX
XC    BXCCXG    CX  
XXXXXXXXXXXXXXXXXX