XCCCCCCCCCCCCCCCCX           
XXCCCCXXXXXXXXXXXX
X                X
XCCCCCCCCCCCCCCCCX
XXXXXXXXXXXXCCCCCX
X                X                
XCCCCCCCBGCCCCCCCX
XCCCCXXXXXXXXCCCCX
XCCCCCCCLCCCCCCCCX            
XXXXXXXXXXXXXXXXXX