X       C        X
XC     CCC      CX
XX    CXXXC     XX
X      BXG       X
XCC   CXXXC    CCX
XXX    CLC     XXX
XCCCCCCCCCCCCCCCCX
XCCCXXXXXXXXXXCCCX
XCCXXXXXXXXXXXXCCX
XXXXXXXXXXXXXXXXXX