XCCC          CCCX
XXXXC   CCC  CXXXX
XCC    CXXXC   CCX
XXX     CCC   CXXX
XCCC   CXXXC  CCCX
XXXXC   CCC  CXXXX
XCC    CXXXC   CCX
XXXC    CCC   CXXX
XCC  G CXXXC B CCX
XXXXXXXXXXXXXXXXXX