XG              BX
XXX     CC     XXX
X      CCCC      X
XCCCCCCCCCCCCCCCCX
X  CCCCCCCCCCCC  X
X    CCCCCCCC    X
X   CCCCCCCCCC   X
X  CCCCC  CCCCC  X
X CCCCC    CCCCC X
XXXXXXXXXXXXXXXXXX